NO ./texture/barrel.xpm
SO ./texture/bluestone.xpm
WE ./texture/purplestone.xpm
EA ./texture/redbrick.xpm

F 150,238,213
C 225,255,255

11111111111111111
100000111000011111
11111011101111111111
1100001110000111
1111101111011111
1000001110011111111
1110001000011111
1111101110011111
101N100000000111
1001010101010111
101010101010111
100010101101011111
1001110101010111111111111111111111
100000001001000000000000000000111
1000101010101000000000000000000001
1001101101001111111111111111111111
11111111111111
