NO ./texture/barrel.xpm
SO ./texture/bluestone.xpm
WE ./texture/purplestone.xpm
EA ./texture/redbrick.xpm

F 150,238,213
C 225,255,255

11111
10N01
11111
