NO ./texture/barrel.xpm
SO ./texture/bluestone.xpm
WE ./texture/purplestone.xpm
EA ./texture/redbrick.xpm

F 150,238,213
C 225,255,255


111111
10000N11
10000101
10000001
10000101
10001001
11111111