NO ./texture/barrel.xpm
SO ./texture/bluestone.xpm
WE ./texture/purplestone.xpm
EA ./texture/redbrick.xpm

F 255,0,0
C 0,255,0

11111111111111111
100000111000011111
11111011101111111111
1100001110000111
1111101111011111
1000001110011111111
1110001000011111
1110101110011111
100N000000000111
1000010101010111
101010101010111
100010101101011111
1001110101010111111111111111111111
100000001001000000000000000000111
1000101010101000000000000000000001
1001101101001111111111111111111111
11111111111111
